NO ./assets/wall.xpm
SO ./assets/wall.xpm
WE ./assets/wall.xpm
EA ./assets/wall.xpm

F 220,255,255
C 225,30,0

        1111111111111111111111111
        1000000000110000000000001
        1011000001110000000000001
        1001000000000000000000001
111111111011000001110000000000001
100000000011000001110111111111111
11110111111111011100000010001
100001111111110111010100100011111
110000001111010111000000000000001
10000000000000001100000010001111
10000000000000001101010010001
11000001110101011111011110N1111
1111011111101011011110100011
111111111111111111111111111